ID,EX1,EX2,EX3,EX4,Exam,Pre Final,Final,Passed?
313467623,3,10,13,23,38,87,87,Yes
304993504,3,10,11,20,36,80,80,Yes
204664999,3,10,13,24,46,96,96,Yes
208785733,3,10,13,14,0,40,0,No
302882337,3,10,13,24,37,87,87,Yes
203026083,3,10,11,22,37,83,83,Yes
203118138,3,10,12,24,33,82,82,Yes
209044973,3,10,11,24,47,95,95,Yes
307901587,3,10,13,24,42,92,92,Yes
204718613,3,9,13,24,39,88,88,Yes
318432689,3,10,11,24,31,79,79,Yes
203522917,3,10,13,23,27,76,54,No
305191157,3,10,9,24,29,75,76,Yes
302967500,3,10,13,23,39,88,88,Yes
315099895,3,10,13,23,47,96,96,Yes
208490185,3,10,13,14,39,79,79,Yes
304851058,3,9,12,22,40,86,86,Yes
316802222,3,9,11,24,49,96,96,Yes
209205285,3,10,13,24,46,96,96,Yes
316383827,3,10,11,23,41,88,88,Yes
208539536,3,10,11,22,45,91,91,Yes
301655015,3,9,12,22,37,83,83,Yes
204251599,3,10,13,24,32,82,82,Yes
204310767,3,10,11,22,38,84,84,Yes
302825070,3,10,12,24,31,80,80,Yes
307923383,3,9,13,23,48,96,96,Yes
318505484,3,10,11,24,36,84,84,Yes
208424861,3,10,11,24,42,90,90,Yes
302577028,3,10,13,24,0,50,0,No
304921505,3,10,11,24,28,76,78,Yes
208939009,3,10,13,12,43,81,81,Yes
203519541,3,9,11,24,41,88,88,Yes
204157861,3,10,13,24,45,95,95,Yes
203537741,3,10,13,24,48,98,98,Yes
308545136,3,9,11,24,45,92,92,Yes
314576349,3,10,13,23,41,90,90,Yes
26550483,3,10,13,17,34,77,77,Yes
311229421,3,10,13,12,42,80,80,Yes
204240246,3,10,13,24,33,83,83,Yes
307993568,3,10,9,24,41,87,87,Yes
312460298,3,10,11,22,43,89,89,Yes
323239566,3,10,13,24,24,74,48,No
204529275,3,10,13,24,42,92,92,Yes
39289657,3,10,13,24,47,97,97,Yes
303011308,3,9,12,22,27,73,54,No
206335283,3,10,0,22,40,75,75,Yes
203740444,3,10,11,24,38,86,86,Yes
305573669,3,10,13,17,31,74,74,Yes
305645806,3,10,13,24,31,81,81,Yes
201628047,3,10,13,24,38,88,88,Yes
305137630,3,10,11,24,44,92,92,Yes
203794581,3,10,13,24,36,86,86,Yes
204182919,3,10,13,24,33,83,83,Yes
204085708,3,10,12,24,32,81,81,Yes
203716709,3,10,11,20,38,82,82,Yes
200924751,3,9,11,24,0,47,0,No
203971866,3,10,13,24,28,78,80,Yes
203774534,3,9,11,14,27,64,54,No
201114568,3,10,13,23,0,49,0,No
204196729,3,10,13,24,37,87,87,Yes
308446624,3,10,13,24,32,82,82,Yes
311401269,3,10,13,23,31,80,80,Yes
204184675,3,10,11,24,41,89,89,Yes
203515598,3,10,11,20,28,74,74,Yes
315338558,3,10,0,22,38,73,73,Yes
203184155,3,10,11,22,35,81,81,Yes
304856321,3,10,9,24,21,67,42,No
308019751,3,10,11,22,47,93,93,Yes
207231556,3,10,13,24,34,84,84,Yes
204186258,3,10,11,23,27,74,54,No
204153720,3,10,11,20,36,80,80,Yes
318469228,3,10,13,14,37,77,77,Yes
311775530,3,10,13,17,30,73,73,Yes
311356950,3,9,13,24,45,94,94,Yes
201082708,3,10,13,24,48,98,98,Yes
201271129,3,10,13,24,33,83,83,Yes
204226278,3,10,13,24,46,96,96,Yes
